00000000000000000000
00000000000000000000
00000000000000000000
000######00###000000
000#..00#0##@##00000
000#..00###000#00000
000#..00000$$0#00000
000#..00#0#0$0#00000
000#..###0#0$0#00000
000####0$0#$00#00000
000000#00$#0$0#00000
000000#0$00$00#00000
000000#00##000#00000
000000#########00000
00000000000000000000
00000000000000000000
00000000000000000000
00000000000000000000
00000000000000000000
00000000000000000000
