____________________
_______#####________
_______#___#________
___#####$_$#####____
___#___$___$___#____
___#_###...###_#____
___#_..$.$.$.._#____
___#_#$.$@$.$#_#____
___#_$.$$_$$.$_#____
___#_.$_..._$._#____
___#_$.$.#.$.$_#____
___#_#$_.#._$#_#____
___#_$_..#.._$_#____
___###_$...$_###____
_____#$_$.$_$#______
_____#__.$.__#______
_____###___###______
_______#####________
____________________
____________________
