____________________
____________________
___#######__________
___#__#__#__________
___#___$_#####______
___#_$##_##__#______
___##_#..##__#______
____#_#....$_#______
____#_#..##__#______
____#_#..##_$##_____
____#_$__##_$_#_____
____#__$_$____#_____
____#@__####$_#_____
____##_$______#_____
_____#_#_######_____
_____#___#__________
_____#####__________
____________________
____________________
____________________
