____________________
____________________
_____#########______
_____#@._##__#______
_____#$.$##__#______
_____#_*_##$_#______
_____#_*_##._#______
_____#_*_##$_#______
____##_*_$_._#______
____#__*.*.._#______
____#___$__$_#______
____##__######______
_____####___________
____________________
____________________
____________________
____________________
____________________
____________________
____________________
