____________________
____________________
____________________
___#############____
___#___________#____
___#_.....$_$__#____
___#_#####$$$####___
___#_#_#_#___#__#___
___#_.....___#$_#___
___#_#_#_#$$$#__#___
___#_.....___#$@#___
___#_#_#_#_$$#__#___
___#_#_#$#$___$_#___
___#___#_____####___
___###########______
____________________
____________________
____________________
____________________
____________________
