____________________
____________________
____________________
_____#######________
_____#_____#________
_____#_***_#________
_____#_*@*_#________
_____#_$.$_#________
_____#_*.*_#________
_____#_$.$_#________
_____#_*.*_###______
_____#_*.*___#______
_____#_***_$_#______
_____#_____###______
_____###__##________
_______####_________
____________________
____________________
____________________
____________________
