____________________
____________________
____________________
_____###____________
____##.##___________
____#...#___________
____#...#___________
____#_._#___________
____#_._######______
____##_##____#####__
_____#$_#$_$_$___#__
_____#__@_$__$_#_#__
_____#$##_#$_$___#__
_____#_##_#__#####__
_____#____####______
_____######_________
____________________
____________________
____________________
____________________
