____________________
____________________
____________________
____________________
____________________
____________________
______#######_______
______#.@_#_#_______
______#$__$_#_______
______#_____#_______
______#__.__#_______
______#_____#_______
______#######_______
____________________
____________________
____________________
____________________
____________________
____________________
____________________
