____________________
____________________
____________________
__####______________
__#__##_____________
__#_$_#_______####__
_##__$#########@_#__
_#_$___________..###
_#__$_#_####__#....#
_###__#_______#....#
___#$_#_$_$_$_$.*..#
___#_$$$_$##########
___#______#_________
___########_________
____________________
____________________
____________________
____________________
____________________
____________________
