____________________
____________________
____________________
_______#####________
____####___####_____
____#_________#_____
____#_$.$#$.$_#_____
____#_.$...$._#_____
____#_$_$.$_$_#_____
____#_#..@..#_#_____
____#_$_$.$_$_#_____
____#_.$...$._#_____
____#_$.$#$.$_#_____
____#_________#_____
____###########_____
____________________
____________________
____________________
____________________
____________________
