____________________
_______#####________
_______#___#________
______##_#_###______
______#____#_#______
______#$#$_#_#______
___####@#_$#_#______
___#.._$#$___#______
___#..$____#_#______
___#.._#_$_$_#______
___##$_#_###_#______
___#___$_$_#_#______
___#_$####_#_###____
___#_$_____#_..#____
___#_$.*###_$..#____
___#_#.*_$___..#____
___#__.._#######____
___#######__________
____________________
____________________
