00000000000000000000
00000000000000000000
00000000000000000000
00000000000000000000
00000000000000000000
00000000000000000000
000000#######0000000
000000#.@0#0#0000000
000000#$*0$0#0000000
000000#000$0#0000000
000000#0..00#0000000
000000#00*00#0000000
000000#######0000000
00000000000000000000
00000000000000000000
00000000000000000000
00000000000000000000
00000000000000000000
00000000000000000000
00000000000000000000
