00000000000000000000
00000000000000000000
00000000#########000
00#######0000#00#000
00#000000$##0$00#000
00#0#$#0#0000#00#000
00#000$0#0$#0#$0#000
00#0#$#$#0$0000##000
00#00000#$#0##$#0000
00#0$0$000$0$00#0000
00#.#..0##000$0#0000
00#....0##$#$00#0000
00#....###@0000#0000
00#..#.#0#######0000
00#....#000000000000
00######000000000000
00000000000000000000
00000000000000000000
00000000000000000000
00000000000000000000
