____________________
____________________
________#########___
__#######____#__#___
__#______$##_$__#___
__#_#$#_#____#__#___
__#___$_#_$#_#$_#___
__#_#$#$#_$____##___
__#_____#$#_##$#____
__#_$_$___$_$__#____
__#.#.._##___$_#____
__#...._##$#$__#____
__#....###@____#____
__#..#.#_#######____
__#....#____________
__######____________
____________________
____________________
____________________
____________________
