00000000000000000000
00000000000000000000
00000#########000000
00000#@.0##00#000000
00000#$.$##00#000000
00000#0*0##$0#000000
00000#0*0##.0#000000
00000#0*0##$0#000000
0000##0*0$0.0#000000
0000#00*.*..0#000000
0000#000$00$0#000000
0000##00######000000
00000####00000000000
00000000000000000000
00000000000000000000
00000000000000000000
00000000000000000000
00000000000000000000
00000000000000000000
00000000000000000000
