00000000000000000000
00000000000000000000
00000000000000000000
00000000000000000000
00000000######000000
0000###0#0000##00000
000##.###0$0$@#00000
000#0...#00#####0000
000#..0.#0$#000##000
000##...000#0$00#000
000#..##$00#$#$0###0
000#00$00#$$0$0000#0
00##0$00000000#000#0
00#0000############0
00######000000000000
00000000000000000000
00000000000000000000
00000000000000000000
00000000000000000000
00000000000000000000
