____________________
____________________
____________________
____________________
____________________
____#############___
____#_._$_._$_._#___
____#_$_._$_._$_#___
____#@###_#_###_#___
____#_$_._$_._$_#___
____#_._$_._$_._#___
____#############___
____________________
____________________
____________________
____________________
____________________
____________________
____________________
____________________
