____________________
____________________
____________________
____________________
____________________
____##########______
____#________##_____
____#_$#$#$#$@#_____
____#_._$...$.#_____
____#__.$...$.#_____
____#.##$#$#$##_____
____#________#______
____##########______
____________________
____________________
____________________
____________________
____________________
____________________
____________________
