____________________
____________________
______####__________
______#__###________
____###__$@##_______
___##___.$__#_______
___#__$###__####____
__##_$.###.$_$.#____
__#__..###..$_##____
__#_$$..#..$_##_____
__###_$.*.$__#______
____#___._$_##______
____##_$$_###_______
_____###__#_________
_______####_________
____________________
____________________
____________________
____________________
____________________
