____________________
____________________
____________________
___######__###______
___#..__#_##@##_____
___#..__###___#_____
___#.._____$$_#_____
___#..__#_#_$_#_____
___#..###_#_$_#_____
___####_$_#$__#_____
______#__$#_$_#_____
______#_$__$__#_____
______#__##___#_____
______#########_____
____________________
____________________
____________________
____________________
____________________
____________________
