____________________
____________________
____________________
____________________
______########______
______##.$.$@#______
______#_*_.$$#______
______#__.$*_#______
______#_#_.$_#______
______#..$_$.#______
______#_$_.__#______
______########______
____________________
____________________
____________________
____________________
____________________
____________________
____________________
____________________
