____________________
____________________
_____######_________
_____#____##________
___###__$__##_______
__##__$$$$__#_______
__#____$@$$_#__###__
__#___$$$$__#_##.#__
__###_$_$__####..#__
____#_#___####...#__
___##_#######....#__
___#__######_...##__
___#__________.##___
___#########__##____
___________####_____
____________________
____________________
____________________
____________________
____________________
