00000000000000000000
00000000000000000000
00000000000000000000
00000000000000000000
00000000000000000000
0000#############000
0000#0.0$0.0$0.0#000
0000#0$0.0$0.0$0#000
0000#@###0#0###0#000
0000#0$0.0$0.0$0#000
0000#0.0$0.0$0.0#000
0000#############000
00000000000000000000
00000000000000000000
00000000000000000000
00000000000000000000
00000000000000000000
00000000000000000000
00000000000000000000
00000000000000000000
