____________________
____________________
____________________
____________________
___########_________
___#______#_________
___#_##$#$####______
___#_@__$_$__#______
___#_$#___#_$##_____
___#____$___$_#_____
___######.#.#_#_____
________#.#.$_#_____
________#.#*#.#_____
________#...__#_____
________#######_____
____________________
____________________
____________________
____________________
____________________
