00000000000000000000
00000000000000000000
00000000000000000000
00000#######00000000
00000#00000#00000000
00000#0***0#00000000
00000#0*@*0#00000000
00000#0$.$0#00000000
00000#0*.*0#00000000
00000#0$.$0#00000000
00000#0*.*0###000000
00000#0*.*000#000000
00000#0***0$0#000000
00000#00000###000000
00000###00##00000000
0000000####000000000
00000000000000000000
00000000000000000000
00000000000000000000
00000000000000000000
