00000000000000000000
00000000000000000000
00000000000000000000
0000000#####00000000
0000####000####00000
0000#000000000#00000
0000#0$.$#$.$0#00000
0000#0.$...$.0#00000
0000#0$0$.$0$0#00000
0000#0#..@..#0#00000
0000#0$0$.$0$0#00000
0000#0.$...$.0#00000
0000#0$.$#$.$0#00000
0000#000000000#00000
0000###########00000
00000000000000000000
00000000000000000000
00000000000000000000
00000000000000000000
00000000000000000000
