____________________
____________________
____________________
____________________
____________________
____________________
______#######_______
______#.@_#_#_______
______#$*_$_#_______
______#___$_#_______
______#_..__#_______
______#__*__#_______
______#######_______
____________________
____________________
____________________
____________________
____________________
____________________
____________________
