____________________
_______############_
_______#__________#_
_______#_#$##$###_#_
____####_#_#____$_#_
__###__$_$_$_$$$#_#_
__#___##$#_#______#_
__#_$$#__$__$_$#$##_
__#@$______#...#_#__
__###_##$###*.*..#__
____#______......#__
____##########...#__
_____________#...#__
_____________#####__
____________________
____________________
____________________
____________________
____________________
____________________
