____________________
____________________
____________________
__________########__
__________#@_____##_
_____######$$$$_$_#_
_____#..____$_#_$_#_
____##..#_$_#_#_$_#_
____#...#_#_$_#_#_#_
__###...#$##$_$_$_#_
__#.....___$____#_#_
__#__...#_$##$#$#_#_
__##_##_#_________#_
__#_____###########_
__#_____#___________
__#######___________
____________________
____________________
____________________
____________________
