00000000000000000000
00000000000000000000
00000000000000000000
000#############0000
000#00000000000#0000
000#0.....$0$00#0000
000#0#####$$$####000
000#0#0#0#000#00#000
000#0.....000#$0#000
000#0#0#0#$$$#00#000
000#0.....000#$@#000
000#0#0#0#0$$#00#000
000#0#0#$#$000$0#000
000#000#00000####000
000###########000000
00000000000000000000
00000000000000000000
00000000000000000000
00000000000000000000
00000000000000000000
