____________________
____________________
____________________
____________________
________######______
____###_#____##_____
___##.###_$_$@#_____
___#_...#__#####____
___#.._.#_$#___##___
___##...___#_$__#___
___#..##$__#$#$_###_
___#__$__#$$_$____#_
__##_$________#___#_
__#____############_
__######____________
____________________
____________________
____________________
____________________
____________________
