00000000000000000000
00000000000000000000
00000000#######00000
00000####...00#00000
00####00###.#0##0000
00#00$0$$0..#00#0000
00#0#$0$0$#.##0#0000
00#000$@00*..#0#0000
00##00$$$0*..#0#0000
000#00000$####0#0000
000######000000#0000
00000000########0000
00000000000000000000
00000000000000000000
00000000000000000000
00000000000000000000
00000000000000000000
00000000000000000000
00000000000000000000
00000000000000000000
