____________________
____________________
____________________
____________####____
___##########..#____
___#___........#____
___#_$_######..##___
#####$_.........#___
#__$__$_$_$__$__#___
#_$$___##$#$$_$_#___
#__@#_$#____$_$_#___
##$##__#_$#___###___
#__$___$__#__##_____
#_$##_########______
#______#____________
########____________
____________________
____________________
____________________
____________________
