00000000000000000000
00000000000000000000
00000000000000000000
000000000000####0000
000##########..#0000
000#000........#0000
000#0$0######..##000
#####$0.........#000
#00$00$0$0$00$00#000
#0$$000##$#$$0$0#000
#00@#0$#0000$0$0#000
##$##00#0$#000###000
#00$000$00#00##00000
#0$##0########000000
#000000#000000000000
########000000000000
00000000000000000000
00000000000000000000
00000000000000000000
00000000000000000000
