____________________
____________________
________#######_____
_____####...__#_____
__####__###.#_##____
__#__$_$$_..#__#____
__#_#$_$_$#.##_#____
__#___$@__*..#_#____
__##__$$$_*..#_#____
___#_____$####_#____
___######______#____
________########____
____________________
____________________
____________________
____________________
____________________
____________________
____________________
____________________
