00000000000000000000
00000000000000000000
00000000000000000000
00000000000000000000
00000000000000000000
0000##########000000
0000#00000000##00000
0000#0$#$#$#$@#00000
0000#0.0$...$.#00000
0000#00.$...$.#00000
0000#.##$#$#$##00000
0000#00000000#000000
0000##########000000
00000000000000000000
00000000000000000000
00000000000000000000
00000000000000000000
00000000000000000000
00000000000000000000
00000000000000000000
