00000000000000000000
00000000000000000000
00000000000000000000
00000000000000000000
000########000000000
000#000000#000000000
000#0##$#$####000000
000#0@00$0$00#000000
000#0$#000#0$##00000
000#0000$000$0#00000
000######.#.#0#00000
00000000#.#.$0#00000
00000000#.#*#.#00000
00000000#...00#00000
00000000#######00000
00000000000000000000
00000000000000000000
00000000000000000000
00000000000000000000
00000000000000000000
