00000000000000000000
00000000000000000000
00000000000000000000
00000000000000000000
000000########000000
000000##.$.$@#000000
000000#0*0.$$#000000
000000#00.$*0#000000
000000#0#0.$0#000000
000000#..$0$.#000000
000000#0$0.00#000000
000000########000000
00000000000000000000
00000000000000000000
00000000000000000000
00000000000000000000
00000000000000000000
00000000000000000000
00000000000000000000
00000000000000000000
